#############
#           #
#           #
#           #
#           #
#           #
#    ##     #
#   #       #
# P         #
#############